WWWWWWWWWWWWWWWWWWWWWWWWWWWWWWWWWWWWWWWWWWWWWWWWWWWWWWWWWWWWWWWWWWWWWWWWWWW
WWWWWWWWWWWWWWWWWWWWWWWWWWWWWWWWWWWWWWWWWWWWWWWWWWWWWWWWWWWWWWWWWWWWWWWWWWW
WWCCCCCCCCCCCCWWWWWWWWWWWWWWWWWWWWWWWWWWWWWWWMWWWWWWWWWWWWWWWWWWWWWWWWWWWWW
WWCFFFFFFFFFFCCCWWWWWWWWWWWWWWWWWWWWWWWWWWWWWWWWWWWWWWWWWWWWWWWWWWWWWWWWWWW
WWCPPPPPPFFHHTTCWWWWWTTTTTTWWWWWWWWWWWWWWWWWWWWWWWWWWWWWWWWWWWWWWWWWWWWWWWW
WWCPPPPPFHHMHTTCWWWWWCTTTTTCWWWWWWWCCCCWWWWWWWWWWWWWWWWWWWWWWWWWWWWWWWWWWWT
WWCPFFFFFHMMHFCWWWWWWCFFFFCWWWWWWWWCHHCWWWWWWWWWWWWWTWWWWWWWWWWWWWWWWWWWWCF
WWCFFFAFHAMHFFCWWWWWWCFFFCWWWWWWWWWCHHCCCCCCCWWWCCCCCWWWWWWWWWWWWWWWWWWWCFF
WWCFFFFHMMHFFFFCWWWWWCWFFWWWWWWWWWWCCHMMMHPPCWWWCFFFCWWWWPWWWWWWWWWWWWWWCFF
WWCPPOHMOHPOPPPCWWWWWWWHHHWWWWWWWWWWWCMMMHPPCWWWCFFFCTTTHHHTTTWWWWWWCFFFFFF
WWCPPHMMHPOPPPPCWWWWWWWMMMWWWWWWWWWWWCMMMHPPPCCWCFFFCWWPHMHPWTTWWWWWWWCFFFF
WWCPHMMHPPPPPPPCWWWWWWWTMWWWWWWWWWWWWCCCCCPPPPPCFFFFCWWWHHHWWWTCFFFFHHHHHHH
WWCHMAHPOPPPPPPPCCWWWWWTWWWWWWWWWWWWWWWWWWCPPPPFFFFFCWWWWPWWWWWCFFFFFHHMMMH
WWWCHAPPPPPPPPPPPCWWWWWCWWWWWWWWWWWWWWWWWWCPPCCCFFCCCWWWWWWWWWWCFFFFFFHHMMM
WWWCCCCCCCCPPPPPPCWWWHHHHHWWWWWWWWWWWWWWWWCPCWWWCCWWWWWWWWWWWWWWCFFFFFFHHMM
WWWWWWWWWWWCFFFFFCTTCHMMMACWCWWWWWWWWWWWWWCPCWWWCCWWWWWWWWWWWWWWWCFFFFFFHHM
WWWWWWWWWWWCFFFFFCWWWHHHHHTCHCTTTTWWWWWWWWCCCWCCJCWWWWWWWWWWWWWWWCFFFFFFFHH
WWWWWWWWWWWCCCCCCCWWWWWCWWWWCWWWWHHHHWWWWWWWWWCJJCWWWWWWWWWWWWWWWCFFFFFFFFH
WWWWWWWWWWTTWWWWWWWWWWWWWWWWWWWWWHMMHWWWWWWWWWCJJCWWWWWWWWWWWWWWWWCFFFFFFFF
WWWWWWWWWTTWWWWWWWWWWWWWWWWWWWWWWHMMHWWWWWWWWWCCCCCCCWWWFWWWWWWWWWCFFFFFFFF
WCCCCWCCCCWWWWWWWWWWWWWWWWWWWWWWWHHHHWWWWWWWWWWWWWWWWWFFFFFWWWWWWWCFFFFFFFF
WCMMHWHMMHWWWWWWWWWWWWWWCCWWWWWWWWWWTWWWWWWWWWWWWWWWWFFFFFFFWWWWWWCFFFFFFFF
WCMMHWWHAHWWWWWWWWWWWCCCJJCCCWWWWWWWTWWWWCCCCCCCCCCCTTFFFFFWWWWWWWWCFFFFFFF
WCHHJJWWJJWWWWWWWWWWWCJHHHHJCWWWWWWWCCCCCDDDDDDDDDDCWWWWFWWWWWWWWWWCFFFFFFF
WCPPJJJWJJJJHHWHHHWCCJJHMMHJJCCWWWWWCDDDDDDDDDDDDDDCWWWWWWWWWWWWWWWCFFFFFFF
WCCCCJJWJJJJMHWHMHTCCJJHMMHJJCCWWWWWCDDDDDDDDDDDDDACWWWWWWWWWWWWWWWCFFFFFFF
WWWWWJJWJJJJMHWHMHWWWCJHHHHJCWWWWWWWCCCCCCDDDDDDDDDCWWWWWWWWWWWWWWWCFFFFFFF
WWWWCJJWWWJJMHHHMHWWWCCCJJCCCWWWWWWWWWWWWCDDDDDDDDDCWWWWWWWWWWWWWWWCFFFFFFH
WWWWWJJJJWJJMHHHHHWWWWWWCCWWWWWWWWWWWWWWWCPPPPPPPPPCWWWWWWWWWWWWWWWCFFFFFHH
WCCCCJJJJWJJHWWWWWWWWWWWCCWWWWWWWWWCWCWWWCPPPPPPPPPCWJJWWHHHWWWWTTTCFFFFFHH
WCPPPJJJJWWWWWWWWWWWWWWWTWWWWWWWWWWCPCWTTCCFFFFFFFFCTJJWWHMHWWTTTWWCFFFFFFH
WCPPPPPPPPPPPCWWWWWWWWWWTWWWWWWWWCCPPPCCWWWCFFFFFFCWWJJWWHMHWTTWWWWCFFFFFFF
WCPWWWPPPPPPPPCWTTTWWWWWCWWWWWWWWCPCPCWWWWWCFFFFFFCWJJJTTHMHTTWWWWWCFFFFFFF
WCFWWWFFFFFFFFFCTWTWWWHHHHHWWWWWWWCWPPCWWWWWCCFFCCWWJJWWWHMHWWWWWWWCFFFFFFF
WCFWWWFFFCCCCCCCWWTTTCHMMMHCWWWWWWWWCWWWWWWWWCFFCWWWJJWWWHHHWWWWWWWWCFFFFFF
WCFFFFFFCWWWWWWCWWWWWWHHHHHWWWWWWWWWWWWWWWWWWWCFCWWWWWWWWWWWWWWWWWWWWCFFFFF
WCFFFFFFCWCCCCWCWWWWWWWWWWWWWWWWWWWWWWWWWWWWWWWCWWWWWWWWWWWWWWWWWWWWWWCFFFF
WCCCCCCCCWCPPCWCWWWWWWWWWWWWWWWWWWWWWWWWWWWWWWWTWWWWWWWWWWWWWWWWWWWWWWWCFFF
WWWWWWWWWWCCCCWCWWWWWWWWWWWWWWWWWWWWWWWWWWWWWWWWWWWWWWWWWWWWWWWWWWWWWWWWCFF
WWWWWWWWWWWWWWWTWWWWWWWWWWWWWWWWWWWWWWWWWWWWWWWWWWWWWWWWWWWWWWWWWWWWWWWWWCF
WWWWWWWWWWWWWWTTWWWWWWWWWWWWWWWWWWWWWWWWWWWWWWWWWWWWWWWWWWWWWWWWWWWWWWWWWWC
WWWWWWWWWWWWWTTWWWWWWWWWWWWWWWWWWWWWWWWWWWWWWWWWWWWWWWWWWWWWWWWWWWWWWWWWWWW
WWWWWWWWWWWWTTWWWWWWWWWWWWWWWWWWWWWWWWWWWWWWWWWWWWWWWWWWWWWWWWWWWWWWWWWWWWW
WWWWWWWWWWWTTWWWWWWWWWWWWWWWWWWWWWWWWWWWWWWWWWWWWWWWWWWWWWWWWWWWWWWWWWWWWWW
WWWWWWWWWWTTWWWWWWWWWWWWWWWWWWWWWWWWWWWWWWWWWWWWWWWWWWWWWWWWWWWWWWWWWWWWWWW
WWWWWWWWWTTWWWWWWWWWWWWWWWWWWWWWWWWWWWWWWWWWWWWWWWWWWWWWWWWWWWWWWWWWWWWWWWW
WWWWWWWWTTWWWWWWWWWWWWWWWWWWWWWWWWCCCCCCCCCCCCCCCCCCCCCCCCCWWWWWWWWWWWWWWWW
WWWWWWWTTWWWWWWWWWWWWWWWWWWWWWWWWWCPPPPHHMMMMMMHHHHFFFFFFFCWWWWWWWWWWWWWWWW
WWWWWWTTWWWWWWWWWWWWWWWWWWWWWWWWWWCPPPPHHMMMMMMCCCCCCCCCCCCTTWWWWWWWWWWWWWT
WWWWCWTWWWWWWCCCWWWWWWWWWWWWWWWWWWCPPPPHHMMMMMMCWWWWWWWWWWWWTWWWWWWWWWWWWWT
WWWPPPPPPPPWWPPPWWWWWWWWWWWWWWWWWWCPPPPHHHHHHHHCWWWWWWWWWWWWTWWWWWWWWWWWWWT
WWWPPPPPPPPWWPPPWWWWWWPPPPPWWWWWWWCPPPPPPPPPPPPCWWWWWWWWWWWTTWWWWWWWWWWWWWP
WWWCFFFFFHHHWFWWWWWWWCFFFFCWWWWWWWWCHHPPPPPPPPPCWWWWWWWWWWWTWWWWWWWWWWWWWCF
WWWCFFFFHMMHFCWWWWWWWCFFFCWWWWWWWWWCHHPPPPPPPPPCCCCCCWWWWWWTWWWWWWWWWWWWCFF
WWWCFFFHMMHFFFFCWWWWWCWFFWWWWWWWWWWCCHMMMHPPPWWWPFFFCWWWWPWTWWWWWWWWWWWWCFF
WCCPPPHMMHPPPPPCWWWWWWWHHHWWWWWWWWWWWCMMMHPPPWWWPFFFCWWWHHHTWWWWWWWWCFFFFFF
WCWCPHMMHPPPPPPCWWWWWWWMMMWWWWWWWWWWWCMMMHPPPWWWPFFFCWWPHMHPWWWWWWWWWWCFFFF
WCWCHMMHPPPPPPPCWWWWWWWTMWWWWWWWWWWWWCCCCCPPPPPCFFFFCWWWHHHWWWWCPPPPPPPPPPP
WCWHMMHPPPPPPPPPCCWWWWWTWWWWWWWWWWWWWWWWWWCPPPPFFFFFCWWWWPWWWWWCPPPPPPPPPPP
WWWCHHPPPPPPPPPPPCWWWWWCWWWWWWWWWWWWWWWWWWCPPCCCFFCCCWWWWWWWWWWCPPPPPPPPPPP
WWWCCCCCCCCPPPPPPCWWWHHHHHWWWWWWWWWWWWWWWWCPCWWWCCWWWWWWWWWWWWWWCPPPPPPPPPP
WWWWWWWWWWWCFFFFFCWWCHMMMHCWCWWWWWWWWWWWWWCPCWWWCCWWWWWWWWWWWWWWWCPPPPPPPPP
WWWWWWWWWWWCFFFFFCWWWHHHHHTCHCTTTTWWWWWWWWCCCWCCJCWWWWWWWWWWWWWWWCPPPPPPPPP
WWWWWWWWWWWCCCCCCCWWWWWCWWWWCWWWWHHHHWWWWWWWWWCJJCWWWWWWWWWWWWWWWCPPPPPPPPP
WWWWWWWWWWWWTWWWWWWWWWWWWWWWWWWWWHMMHWWWWWWWWWCJJCWWWWWWWWWWWTTTTTCPPPPPPPP
WWWWWWWWWWWTTWWWWWWWWWWWWWWWWWWWWHMMHWWWWWWWWWCCCCCCCWWWFWWWTTWWWWCPPPPPPPP
WCCCCCCCCCTTWWWWWWWWWWWWWWWWWWWWWHHHHWWWWWWWWWWWWWWWTWFFFFFTTWWWWWWCPPPPPPP
WCMMHWHMMHWWWWWWWWWWWWWWCCWWWWWWWWWWTWWWWWWWWWWWWWWWTFFFFFFFWWWWWWCPPPPPPPP
WCMMHWWHMHWWWWWWWWWWWCCCJJCCCWWWWWWWTWWWWCCCCCCCCCCCTWFFFFFWWWWWWWWCPPPPPPP
WCHHJJWWJJWWWWWWWWWWWCJHHHHJCWWWWWWWCCCCCFFFFFFFFFFCWWWWFWWWWWWWWWWCPPPPPPP
WCPPJJJWJJJJHHWHHHWCCJJHMMHJJCCWWWWWCFFFFFFFFFFFFFFCWWWWWWWWWWWWWWWCPPPPPPP
WCCCCJJWJJJJMHWHMHTCCJJHMMHJJCCWWWWWCFFFFFFFFFFFFFFCWWWWWWWWWWWWWWWCPPPPPPP
WWWWWJJWJJJJMHWHMHWWWCJHHHHJCWWWWWWWCCCCCCFFFFFFFFFCWWWWWWWWWWWWWWWCPPPPPPP
WWWWCJJWWWJJMHHHMHWWWCCCJJCCCWWWWWWWWTWWWCFFFFFFFFFCWWWWWWWWWWWWWWWCPPPPPPP
WWWWWJJJJWJJMHHHHHWWWWWWCCWWWWWWWWWWWTWWWCFFFFFFFFFFCCCCCCCCWWWWWWWCPPPPPPP
WCCCCJJJJWJJHWWWWWWWWWWWCCWWWWWWWWWCWCWWWCFFFFFFFFFJJJJJJJJCWWWWWWWCPPPPPPP
WCPPPJJJJWWWWWWWWWWWWWWWWTWWWWWWWWWCPCWWWCCFFFFFFFFJJJJWWJMCWWWWWWWCPPPPPPP
WCPPPPPPPPPPPCWWWWWWWWWWWTWWWWWWWCCPPPCCWWWCFFFFFFJJJJJWWJMCWWWWWWWCPPPPPPP
WCPWWWPPPPPPPPCWWWWWWWWWCTWWWWTTTCPCPCWWWWWCFFFFFFJJJJJWWJMCWWWWWWWCPPPPPPP
WCFWWWFFFFFFFFFCWWWWWWHHHHHWWWTWWWCWPPCWWWWWWCFFFJJJJJWWWJMCWWWWWWWCJJJJJJJ
WCFWWWFFFCCCCCCCWWWWWCHMMMHCTTTWWWWWCWWWWWWWWCFFFJJJJJWWWJMCWWWWWWWWCJJJJJJ
WCFFFFFFCWWWWWWCWWWWWTHHHHHWWWWWWWWWWWWWWWWWWWCFFJJJWWWWWJMCWWWWWWWWWCJJJJJ
WCFFFFFFCWCCCCWCWWWWTTWWWWWWWWWWWWWWWWWWWWWWWWWTCCCCCCCCCCCCWWWWWWWWWWCJJJJ
WCCCCCCCCWCPPCWCWWWTTWWWWWWWWWWWWWWWWWWWWWWWWWWWWWWWWWWWWWWWWWWWWWWWWWWCJJJ
WWWWWWWWWWCCCCWCWWWTWWWWWWWWWWWWWWWWWWWWWWWWWWWWWWWWWWWWWWWWWWWWWWWWWWWWCJJ
WWWWWWWWWWWWTWWWWWTTWWWWWWWWWWWWWWWWWWWWWWWWWWWWWWWWWWWWWWWWWWWWWWWWWWWWWCJ
WWWWWWWWWWWWTWWWWTTWWWWWWWWWWWWWWWWWWWWWWWWWWWWWWWWWWWWWWWWWWWWWWWWWWWWWWWC
WWWWWWWWWWWWTTWTTTWWWWWWWWWWWWWWWWWWWWWWWWWWWWWWWWWWWWWWWWWWWWWWWWWWWWWWWWW
WWWWWWWWWWWWWTTTWWWWWWWWWWWWWWWWWWWWWWWWWWWWWWWWWWWWWWWWWWWWWWWWWWWWWWWWWWW
WWWWWWWWWWWWWWWWWWWWWWWWWWWWWWWWWWWWWWWWWWWWWWWWWWWWWWWWWWWWWWWWWWWWWWWWWWW
WWWWWWWWWWWWWWWWWWWWWWWWWWWWWWWWWWWWWWWWWWWWWWWWWWWWWWWWWWWWWWWWWWWWWWWWWWW
WWWWWWWWWWWWWWWWWWWWWWWWWWWWWWWWWWWWWWWWWWWWWWWWWWWWWWWWWWWWWWWWWWWWWWWWWWW
WWWWWWWWWWWWWWWWWWWWWWWWWWWWWWWWWWWWWWWWWWWWWWWWWWWWWWWWWWWWWWWWWWWWWWWWWWW
WWWWWWWWWWWWWWWWWWWWWWWWWWWWWWWWWWWWWWWWWWWWWWWWWWWWWWWWWWWWWWWWWWWWWWWWWWW
WWWWWWWWWWWWWWWWWWWWWWWWWWWWWWWWWWWWWWWWWWWWWWWWWWWWWWWWWWWWWWWWWWWWWWWWWWW
WWWWWWWWWWWWWWWWWWWWWWWWWWWWWWWWWWWWWWWWWWWWWWWWWWWWWWWWWWWWWWWWWWWWWWWWWWW
WWWWWWWWWWWWWWWWWWWWWWWWWWWWWWWWWWWWWWWWWWWWWWWWWWWWWWWWWWWWWWWWWWWWWWWWWWW
WWWWWWWWWWWWWWWWWWWWWWWWWWWWWWWWWWWWWWWWWWWWWWWWWWWWWWWWWWWWWWWWWWWWWWWWWWW
WWWWWWWWWWWWWWWWWWWWWWWWWWWWWWWWWWWWWWWWWWWWWWWWWWWWWWWWWWWWWWWWWWWWWWWWWWW
WWWWWWWWWWWWWWWWWWWWWWWWWWWWWWWWWWWWWWWWWWWWWWWWWWWWWWWWWWWWWWWWWWWWWWWWWWW

The known world 25 squares had to be cut off on the End to fit in the help file

PENDING CHANGES do not be surprised
+TLNY2020
