 ___________________ ___     ___ _______________
|                   |XX |   |XX |               |
|    _______________|___|   |___|___________    |
|   |               |Christina St           |   |
|   |               |    ___     _______    |   |
|   |  ARENA        |   | H |   |   | O | T |   |
|   |        ___ ___|   |___|   |   |___| r |   |
|   |       |  MT   |Holy row   |       | a |   |
|___|_______|___ ___|    ___    |       | c |___|
|XX |       | L |CH |   | t |   |       | k |XX |
|___|       |___|___|   |___|   |_______| e |___|
     <----------Northern Row------------> r
 _______     ___     ___     ___________  s  ___ 
|XX |   | G | I |///| J |   |PO | G | T |   |XX |
|___|   | u |___|///|___|   |___|___|___| a |___|
|   |   | a |   |///////     ///////|   | v =   |
|   |GL | r |___|/// ___     ___ ///|___| e |   |
|   |   | d |   |///| M |   | B |///|   |   |   |
|___|   | s |___|///|___|   |___|///|___|   |___|
|XX |   | l |   |///| W |   | A |///|   |   |XX |
|___|___| e |___|///|___|   |___|///|___|   |___|
      <---g---Southern Row--------------->     
 ___     ___     ___ ___ &&& ___     _______ ___
|XX | G |   |///| L | C |   |GS |   |       |XX |
|___| u |___|///|___|___|   |___|   |stables|___|
|   | a |   |///////////            |       |   |
|   | r |___|___ ___ ___     ___ ___|___ ___|   |
|   | d |   |   |   |   |   |   |   |   |   |   |
|   | s |___|___|___|___| ^ |___|___|___|___|   |
|   |  <-------Commoners Row----------->    |   |
|   | w  ___ ___ ___ ___  |  ___ ___ ___ ___|   |
|   | a |   |   |   |   |1st|   |   |   |   |   |
|   | l |___|___|___|___|st.|___|___|___|___|   |
|   | k |   |   |   |   | | |   |   |   |   |   |
|   |   |___|___|___|___|   |___|___|___|___|   |
|   | <--------------Peon Row----------->   |   |
|   |_______________ ___     _______________|   |
|                   |XX |   |XX |               |
|___________________|___|   |___|_______________|


Shao-Tan Legend

"X" - Guard Posts       "I" - Inn & Bar         
"A" - Armour Shop       "t" - Church
"W" - Weapon Shop       "PO" - Post office
"L" - Leather Shop      "J" - Jail
"C" - Clothing Shop     "M" - Militia Guild
"GS" - General Store    "CH" - City Hall

"L" - Lybrary
"B" - Bank                         
/// - Alley                          
&&& - Executioners Square



